[{
        "type": 0,
        "layout": [
            ["X", "X", "X", "X", "X", "X", "X", "X", "X", "X", "X"],
            ["X", "G", "W", "W", "W", "W", "W", "W", "W", "W", "X"],
            ["X", "G", "G", "G", "G", "G", "G", "1685481132", "G", "W", "X"],
            ["X", "G", "G", "G", "P", "G", "P", "W", "W", "W", "X"],
            ["X", "G", "G", "G", "G", "G", "G", "G", "G", "W", "X"],
            ["X", "G", "W", "W", "W", "P", "W", "G", "W", "W", "X"],
            ["X", "S", "W", "G", "G", "G", "G", "G", "W", "G", "X"],
            ["X", "S", "W", "G", "2896142542", "G", "G", "1983293142", "W", "G", "X"],
            ["X", "G", "W", "W", "W", "W", "G", "G", "G", "G", "X"],
            ["X", "G", "G", "G", "G", "G", "G", "W", "W", "W", "X"],
            ["X", "X", "X", "X", "X", "X", "X", "X", "X", "X", "X"]
        ]
    },
    {
        "type": 1,
        "layout": [
            ["X", "X", "X", "X", "X", "X", "X", "X", "X", "X", "X"],
            ["X", "G", "1582162149", "G", "W", "W", "W", "G", "G", "G", "X"],
            ["X", "G", "G", "G", "W", "G", "G", "G", "G", "G", "X"],
            ["X", "S", "G", "G", "W", "W", "G", "G", "G", "G", "X"],
            ["X", "S", "G", "G", "W", "G", "G", "G", "G", "G", "X"],
            ["X", "G", "G", "G", "W", "P", "G", "1081151244", "G", "G", "X"],
            ["X", "G", "W", "G", "W", "G", "G", "G", "G", "W", "X"],
            ["X", "W", "W", "G", "G", "G", "G", "G", "G", "W", "X"],
            ["X", "W", "W", "W", "W", "G", "G", "G", "G", "W", "X"],
            ["X", "W", "W", "G", "W", "W", "W", "W", "W", "W", "W"],
            ["X", "X", "X", "X", "X", "X", "X", "X", "X", "X", "X"]
        ]
    },
    {
        "type": 2,
        "layout": [
            ["X", "X", "X", "X", "X", "X", "X", "X", "X", "X", "X"],
            ["X", "G", "G", "G", "G", "G", "G", "G", "G", "G", "X"],
            ["X", "G", "W", "W", "W", "G", "G", "G", "G", "G", "X"],
            ["X", "G", "W", "G", "W", "W", "G", "G", "G", "W", "X"],
            ["X", "G", "W", "G", "W", "G", "G", "1582113218", "G", "W", "X"],
            ["X", "S", "G", "G", "W", "P", "G", "1582141245", "G", "W", "X"],
            ["X", "S", "W", "G", "W", "G", "G", "G", "G", "W", "X"],
            ["X", "W", "W", "G", "G", "G", "G", "G", "G", "G", "X"],
            ["X", "W", "W", "W", "G", "G", "G", "G", "G", "G", "X"],
            ["X", "G", "W", "2289642271", "G", "W", "W", "W", "W", "W", "W"],
            ["X", "X", "X", "X", "X", "X", "X", "X", "X", "X", "X"]
        ]
    },
    {
        "type": 3,
        "layout": [
            ["X", "X", "X", "X", "X", "X", "X", "X", "X", "X", "X"],
            ["X", "W", "1582141255", "G", "W", "S", "S", "G", "G", "G", "X"],
            ["X", "W", "W", "G", "W", "W", "G", "W", "G", "3986732412", "X"],
            ["X", "W", "W", "G", "W", "W", "G", "G", "G", "G", "X"],
            ["X", "W", "W", "G", "G", "G", "G", "W", "G", "G", "X"],
            ["X", "G", "G", "G", "W", "P", "G", "W", "G", "G", "X"],
            ["X", "G", "W", "G", "1241213390", "W", "W", "G", "G", "G", "X"],
            ["X", "W", "W", "G", "G", "G", "G", "G", "G", "G", "X"],
            ["X", "W", "W", "W", "W", "G", "G", "G", "G", "G", "X"],
            ["X", "G", "W", "G", "W", "W", "W", "W", "W", "W", "W"],
            ["X", "X", "X", "X", "X", "X", "X", "X", "X", "X", "X"]
        ]
    },
    {
        "type": 4,
        "layout": [
            ["X", "X", "X", "X", "X", "X", "X", "X", "X", "X", "X"],
            ["X", "W", "W", "S", "S", "G", "G", "W", "W", "W", "X"],
            ["X", "G", "W", "G", "W", "G", "G", "W", "W", "W", "X"],
            ["X", "G", "W", "G", "W", "W", "G", "G", "G", "G", "X"],
            ["X", "G", "W", "G", "W", "G", "G", "G", "G", "G", "X"],
            ["X", "G", "G", "G", "W", "P", "G", "1582142144", "1586411176", "G", "X"],
            ["X", "G", "W", "G", "G", "G", "G", "G", "G", "G", "X"],
            ["X", "W", "W", "G", "G", "G", "G", "G", "G", "G", "X"],
            ["X", "W", "W", "W", "W", "G", "G", "G", "G", "G", "X"],
            ["X", "G", "W", "G", "W", "W", "W", "W", "W", "W", "X"],
            ["X", "X", "X", "X", "X", "X", "X", "X", "X", "X", "X"]
        ]
    },
    {
        "type": 5,
        "layout": [
            ["X", "X", "X", "X", "X", "X", "X", "X", "X", "X", "X"],
            ["X", "W", "W", "G", "G", "G", "G", "G", "G", "G", "X"],
            ["X", "W", "W", "G", "W", "W", "G", "W", "G", "G", "X"],
            ["X", "G", "G", "G", "W", "W", "W", "W", "G", "W", "X"],
            ["X", "G", "G", "G", "G", "W", "5123121141", "W", "G", "G", "X"],
            ["X", "G", "G", "G", "G", "P", "G", "1081112421", "G", "G", "X"],
            ["X", "G", "W", "G", "G", "W", "G", "G", "G", "G", "X"],
            ["X", "S", "W", "G", "G", "1125123123", "G", "G", "G", "G", "X"],
            ["X", "S", "W", "G", "W", "G", "G", "G", "G", "G", "X"],
            ["X", "G", "W", "G", "G", "W", "W", "W", "W", "W", "W"],
            ["X", "X", "X", "X", "X", "X", "X", "X", "X", "X", "X"]
        ]
    },
    {
        "type": 6,
        "layout": [
            ["X", "X", "X", "X", "X", "X", "X", "X", "X", "X", "X"],
            ["X", "S", "G", "G", "G", "G", "G", "W", "W", "W", "X"],
            ["X", "S", "W", "W", "W", "G", "G", "G", "W", "W", "X"],
            ["X", "G", "W", "G", "W", "W", "G", "G", "G", "W", "X"],
            ["X", "W", "W", "G", "G", "G", "G", "W", "G", "G", "X"],
            ["X", "G", "G", "G", "G", "P", "W", "1582121376", "G", "G", "X"],
            ["X", "G", "W", "G", "G", "W", "W", "W", "G", "G", "X"],
            ["X", "W", "W", "G", "G", "G", "G", "G", "G", "G", "X"],
            ["X", "W", "W", "G", "W", "G", "G", "G", "G", "G", "X"],
            ["X", "G", "3411422967", "G", "G", "W", "W", "W", "W", "W", "X"],
            ["X", "X", "X", "X", "X", "X", "X", "X", "X", "X", "X"]
        ]
    }, {
        "type": 7,
        "layout": [
            ["X", "X", "X", "X", "X", "X", "X", "X", "X", "X", "X"],
            ["X", "G", "W", "W", "W", "W", "W", "W", "W", "W", "X"],
            ["X", "G", "G", "G", "G", "G", "G", "1685481111", "G", "W", "X"],
            ["X", "G", "G", "G", "G", "G", "W", "W", "W", "W", "X"],
            ["X", "G", "G", "G", "G", "G", "G", "G", "G", "W", "X"],
            ["X", "G", "W", "W", "W", "P", "W", "G", "W", "W", "X"],
            ["X", "S", "W", "G", "G", "G", "G", "G", "W", "G", "X"],
            ["X", "S", "W", "G", "2896142145", "G", "G", "1983293518", "W", "G", "X"],
            ["X", "G", "W", "W", "W", "W", "G", "G", "G", "G", "X"],
            ["X", "G", "G", "G", "G", "G", "G", "W", "W", "W", "X"],
            ["X", "X", "X", "X", "X", "X", "X", "X", "X", "X", "X"]
        ]
    }, {
        "type": 8,
        "layout": [
            ["X", "X", "X", "X", "X", "X", "X", "X", "X", "X", "X"],
            ["X", "G", "W", "W", "W", "W", "W", "W", "W", "W", "X"],
            ["X", "G", "G", "G", "G", "G", "G", "w", "G", "W", "X"],
            ["X", "W", "W", "W", "W", "W", "G", "W", "W", "W", "X"],
            ["X", "W", "G", "G", "G", "G", "G", "G", "G", "W", "X"],
            ["X", "W", "G", "W", "W", "P", "W", "G", "W", "W", "X"],
            ["X", "S", "G", "G", "W", "G", "G", "G", "W", "G", "X"],
            ["X", "S", "W", "W", "4587123132", "G", "G", "1982241298", "1983385129", "G", "X"],
            ["X", "G", "W", "W", "W", "W", "G", "G", "G", "G", "X"],
            ["X", "G", "G", "G", "G", "G", "G", "W", "W", "W", "X"],
            ["X", "X", "X", "X", "X", "X", "X", "X", "X", "X", "X"]
        ]
    }, {
        "type": 9,
        "layout": [
            ["X", "X", "X", "X", "X", "X", "X", "X", "X", "X", "X"],
            ["X", "W", "W", "W", "W", "W", "W", "W", "W", "W", "X"],
            ["X", "G", "6542411317", "G", "G", "G", "G", "1685483129", "G", "W", "X"],
            ["X", "G", "G", "G", "G", "W", "G", "W", "W", "W", "X"],
            ["X", "G", "G", "G", "G", "G", "G", "G", "G", "W", "X"],
            ["X", "G", "W", "W", "W", "P", "W", "G", "W", "W", "X"],
            ["X", "G", "W", "G", "W", "W", "G", "G", "W", "G", "X"],
            ["X", "S", "W", "G", "2896143125", "G", "G", "W", "W", "G", "X"],
            ["X", "S", "G", "G", "W", "W", "G", "G", "G", "G", "X"],
            ["X", "G", "G", "G", "G", "G", "G", "W", "W", "W", "X"],
            ["X", "X", "X", "X", "X", "X", "X", "X", "X", "X", "X"]
        ]
    }, {
        "type": 10,
        "layout": [
            ["X", "X", "X", "X", "X", "X", "X", "X", "X", "X", "X"],
            ["X", "G", "W", "W", "W", "W", "W", "W", "W", "W", "X"],
            ["X", "S", "G", "G", "G", "G", "G", "W", "G", "W", "X"],
            ["X", "S", "W", "G", "2130121876", "G", "G", "W", "W", "W", "X"],
            ["X", "G", "W", "G", "G", "W", "G", "G", "G", "W", "X"],
            ["X", "G", "W", "G", "G", "P", "W", "G", "W", "W", "X"],
            ["X", "W", "G", "G", "G", "G", "G", "G", "W", "G", "X"],
            ["X", "W", "G", "G", "2896142125", "G", "G", "G", "W", "G", "X"],
            ["X", "W", "G", "W", "W", "W", "G", "G", "G", "G", "X"],
            ["X", "G", "G", "G", "G", "G", "G", "W", "W", "W", "X"],
            ["X", "X", "X", "X", "X", "X", "X", "X", "X", "X", "X"]
        ]
    }, {
        "type": 11,
        "layout": [
            ["X", "X", "X", "X", "X", "X", "X", "X", "X", "X", "X"],
            ["X", "G", "S", "S", "W", "W", "W", "W", "W", "W", "X"],
            ["X", "W", "W", "G", "G", "G", "G", "W", "G", "G", "X"],
            ["X", "W", "W", "G", "G", "G", "G", "W", "W", "G", "X"],
            ["X", "G", "W", "G", "G", "W", "G", "G", "G", "G", "X"],
            ["X", "G", "W", "W", "W", "P", "W", "G", "W", "G", "X"],
            ["X", "W", "G", "G", "G", "G", "G", "G", "W", "G", "X"],
            ["X", "W", "G", "G", "2896512133", "G", "G", "G", "W", "G", "X"],
            ["X", "W", "G", "W", "W", "W", "G", "G", "G", "3251211865", "X"],
            ["X", "G", "G", "G", "G", "G", "G", "W", "W", "W", "X"],
            ["X", "X", "X", "X", "X", "X", "X", "X", "X", "X", "X"]
        ]
    }, {
        "type": 12,
        "layout": [
            ["X", "X", "X", "X", "X", "X", "X", "X", "X", "X", "X"],
            ["X", "W", "S", "S", "G", "G", "G", "G", "G", "W", "X"],
            ["X", "W", "W", "G", "G", "G", "G", "W", "G", "W", "X"],
            ["X", "W", "W", "W", "G", "G", "G", "W", "W", "W", "X"],
            ["X", "G", "W", "W", "G", "W", "G", "G", "G", "W", "X"],
            ["X", "G", "W", "G", "G", "P", "W", "G", "G", "W", "X"],
            ["X", "W", "W", "W", "G", "G", "W", "W", "G", "W", "X"],
            ["X", "4535122786", "G", "G", "W", "W", "G", "G", "W", "G", "X"],
            ["X", "W", "G", "W", "W", "W", "G", "G", "G"," 3217841288", "X"],
            ["X", "G", "G", "G", "G", "G", "G", "W", "W", "W", "X"],
            ["X", "X", "X", "X", "X", "X", "X", "X", "X", "X", "X"]
        ]
    }
]