[
    {
        "type": 0,
        "layout":[    
            ["X","X","X","X","X","X","X","X","X","X","X"],
            ["X","D","D","G","G","D","D","D","D","D","X"],
            ["X","D","W","D","W","D","D","D","D","D","X"],
            ["X","D","W","D","W","W","D","D","D","D","X"],
            ["X","D","W","D","W","D","D","D","D","D","X"],
            ["X","D","D","D","W","D","D",15821,"D","D","X"],
            ["X","W","W","D","W","D","D","D","D","D","X"],
            ["X","W","W","D","D","D","D","D","D","D","X"],
            ["X","W","W","W","W",15821,"D","D","D","D","X"],
            ["X","D","W","D","W","W","W","W","W","W","W"],
            ["X","X","X","X","X","X","X","X","X","X","X"]
        ]
    },
    {
        "type": 1,
        "layout":[
            ["X","X","X","X","X","X","X","X","X","X","X"],
            ["X","D",15821,"D","W","D","D","D","D","D","X"],
            ["X","D","D","D","W","D","D","D","D","D","X"],
            ["X","D","D","D","W","W","D","D","D","D","X"],
            ["X","D","D","D","W","D","D","D","D","D","X"],
            ["X","G","D","D","W","D","D",10811,"D","D","X"],
            ["X","G","W","D","W","D","D","D","D","D","X"],
            ["X","W","W","D","D","D","D","D","D","D","X"],
            ["X","W","W","W","W","D","D","D","D","D","X"],
            ["X","W","W","D","W","W","W","W","W","W","W"],
            ["X","X","X","X","X","X","X","X","X","X","X"]
        ]
    },
    {
        "type": 2,
        "layout":[    
            ["X","X","X","X","X","X","X","X","X","X","X"],
            ["X","D","D","D","D","D","D","D","D","D","X"],
            ["X","D","W","D","W","D","D","D","D","D","X"],
            ["X","D","W","D","W","W","D","D","D","D","X"],
            ["X","D","W","D","W","D","D",15821,"D","D","X"],
            ["X","G","D","D","W","D","D",15821,"D","D","X"],
            ["X","G","W","D","W","D","D","D","D","D","X"],
            ["X","W","W","D","D","D","D","D","D","D","X"],
            ["X","W","W","W","W","D","D","D","D","D","X"],
            ["X","D","W","D","W","W","W","W","W","W","W"],
            ["X","X","X","X","X","X","X","X","X","X","X"]
        ]
    },
    {
        "type": 3,
        "layout":[
            ["X","X","X","X","X","X","X","X","X","X","X"],
            ["X","D",15821,"D","W","D","D","D","D","D","X"],
            ["X","D","D","D","W","W","W","W","D","D","X"],
            ["X","D","D","D","W","W","W","D","D","D","X"],
            ["X","D","D","D","W","D","W","W","D","D","X"],
            ["X","G","D","D","W","D","D","W","D","D","X"],
            ["X","G","W","D",124123,"D","D","D","D","D","X"],
            ["X","W","W","D","D","D","D","D","D","D","X"],
            ["X","W","W","W","W","D","D","D","D","D","X"],
            ["X","D","W","D","W","W","W","W","W","W","W"],
            ["X","X","X","X","X","X","X","X","X","X","X"]
        ]
    },
    {
        "type": 4,
        "layout":[    
            ["X","X","X","X","X","X","X","X","X","X","X"],
            ["X","D","D","D","D","D","D","D","D","D","X"],
            ["X","D","W","D","W","D","D","D","D","D","X"],
            ["X","D","W","D","W","W","D","D","D","D","X"],
            ["X","D","W","D","W","D","D","D","D","D","X"],
            ["X","G","D","D","W","D","D",15821,15821,"D","X"],
            ["X","G","W","D","W","D","D","D","D","D","X"],
            ["X","W","W","D","D","D","D","D","D","D","X"],
            ["X","W","W","W","W","D","D","D","D","D","X"],
            ["X","D","W","D","W","W","W","W","W","W","W"],
            ["X","X","X","X","X","X","X","X","X","X","X"]
        ]
    },
    {
        "type": 5,
        "layout":[
            ["W","W","W","X","X","X","X","X","X","X","X"],
            ["W","W","W","D","W","D","D","D","D","D","X"],
            ["W","W","W","W","D","D","D","D","D","D","X"],
            ["X","D","D","D","D","W","D","D","D","D","X"],
            ["X","D","D","D","D","D",51231,"D","D","D","X"],
            ["X","G","D","D","D","D","D",10811,"D","D","X"],
            ["X","G","W","D","D","D","D","D","D","D","X"],
            ["X","W","W","D","D",124123,"D","D","D","D","X"],
            ["X","W","W","W","W","D","D","D","D","D","X"],
            ["X","D","W","D","W","W","W","W","W","W","W"],
            ["X","X","X","X","X","X","X","X","X","X","X"]
        ]
    },
    {
        "type": 6,
        "layout":[    
            ["X","X","X","X","X","X","X","X","X","X","X"],
            ["X","D","D","D","D","D","D","D","D","D","X"],
            ["X","D","W","D","W","D","D","D","D","D","X"],
            ["X","D","W","D","W","W","D","D","D","D","X"],
            ["X","D","W","D","W","D","D","D","D","D","X"],
            ["X","G","D","D","W","D","D",15821,"D","D","X"],
            ["X","G","W","D","W","D","D","D","D","D","X"],
            ["X","W","W","D","D","D","D","D","D","D","X"],
            ["X","W","W","W","W","D","D","D","D","D","X"],
            ["X","D","W","D","W","W","W","W","W","W","W"],
            ["X","X","X","X","X","X","X","X","X","X","X"]
        ]   
    }
]